Date,CumulativeEqs,DisposalVolume,CumDisposalVolume,ProducedGas,CumProducedGas,ProducedOil,Cum_ProducedOil,ProducedWater,CumProducedWater,WellCount,DomesticFlightsDFW,InternationalFlightsDFW,TotalFlightsDFW,Precipitation,Evaporation,NetEvaporation,GroundwaterLvlDiff,ReservoirStorage,ConservationStorage,PercentFull
Jan-93,0,496305,59311729,8222469,8222469,107394,107394,674968,674968,4435,595,102,697,2.27,1.7875,-0.4825,0,3591821.23,3452027.1,99.67
Feb-93,0,959611,119086764,15715050,15715050,109100,216494,651935,1326903,4427,579,96,675,4.6975,1.9625,-2.735,-2.13,3691187.46,3460436,99.91
Mar-93,0,1484221,179386409,23731241,23731241,112840,329334,667942,1994845,4454,580,105,685,3.145,3.1175,-0.0275,-5.2,3795578.39,3460517.23,99.9
Apr-93,0,1965439,240167272,31144782,31144782,94879,424213,589565,2584410,4462,615,106,721,4.065,4.2025,0.1375,-8.29,3622013.17,3459418.73,99.88
May-93,0,2455177,301437873,38427373,38427373,97713,521926,530050,3114460,4472,569,110,679,3.2925,4.65,1.3575,-10.78,3642769.55,3459058.9,99.87
Jun-93,0,2891962,363145259,45580391,45580391,96104,618030,498987,3613447,4475,624,111,735,3.7375,6.0875,2.35,-12.21,3602520.13,3441939.63,99.38
Jul-93,0,3350247,425310930,52954284,52954284,95036,713066,501167,4114614,4463,609,112,721,0.0275,10.4575,10.43,-12.25,3351497.32,3227593.03,93.18
Aug-93,0,3809976,487936330,59058022,59058022,86788,799854,481917,4596531,4508,601,111,712,1.2725,9.5075,8.235,-9.31,3154843.13,3057345.52,88.27
Sep-93,0,4245234,550996988,66712582,66712582,91822,891676,509409,5105940,4493,670,97,767,4.33,7.0675,2.7375,-9.12,3045697.93,2969063.33,85.73
Oct-93,0,4716347,614528759,74040894,74040894,94565,986241,498488,5604428,4491,630,92,722,7.7175,4.605,-3.1125,-8.78,3157051.45,3044005.81,87.88
Nov-93,0,5728398,679072581,81035607,81035607,93590,1079831,465072,6069500,4514,617,102,719,1.9925,2.9125,0.92,-8.34,3309419.8,3177794.33,91.75
Dec-93,0,6660857,744548862,88362360,88362360,95072,1174903,478893,6548393,4497,680,109,789,2.67,2.3075,-0.3625,-7.62,3373448.23,3209682.52,92.67
Jan-94,0,7699899,811064185,95541195,95541195,105978,1280881,519730,7068123,4497,653,106,759,1.4275,1.8425,0.415,-7.14,3307976.48,3183727.94,91.93
Feb-94,0,8464998,878344607,101997160,101997160,90681,1371562,452877,7521000,4480,644,103,747,2.5875,1.8975,-0.69,-6.87,3296237.25,3191950.82,92.16
Mar-94,0,9329282,946489313,109163524,109163524,103557,1475119,506542,8027542,4474,649,107,756,2.4275,3.7775,1.35,-9.29,3327270.03,3209479.39,92.66
Apr-94,0,10000480,1015305217,116218866,116218866,104131,1579250,574479,8602021,4488,670,105,775,3.3775,4.66,1.2825,-11.87,3272188.83,3195097.07,92.25
May-94,0,10922720,1085043361,123497725,123497725,111085,1690335,592871,9194892,4481,607,139,746,6.0625,3.815,-2.2475,-14.7,3458291.65,3220018.61,92.97
Jun-94,0,11640847,1155499632,130633881,130633881,101783,1792118,561336,9756228,4487,648,150,798,2.0375,6.3725,4.335,-16.95,3317328.37,3206859.33,92.58
Jul-94,0,12641296,1226956352,137965217,137965217,100514,1892632,541408,10297636,4478,630,141,771,5.095,7.04,1.945,-17.14,3436011.42,3261857.68,94.17
Aug-94,0,13352638,1299124414,145254634,145254634,99764,1992396,539011,10836647,4491,617,121,738,2.32,6.905,4.585,-17.16,3360411.07,3283208.07,94.79
Sep-94,0,14243439,1372183277,152251949,152251949,91001,2083397,463780,11300427,4488,671,118,789,4.025,4.8725,0.8475,-16.44,3344849.73,3269112,94.39
Oct-94,0,14939433,1445938134,159471006,159471006,96879,2180276,469786,11770213,4473,624,106,730,7.4175,3.895,-3.5225,-16.68,3395349.42,3263848.19,94.23
Nov-94,0,15268596,1520022154,166375456,166375456,94916,2275192,454903,12225116,4490,589,102,691,6.3675,2.6075,-3.76,-17.87,3747757.07,3390865.37,97.91
Dec-94,0,15630110,1594467688,173529316,173529316,92449,2367641,445824,12670940,4488,653,113,766,3.2525,1.5425,-1.71,-19.6,3792890.58,3459639.48,99.89
Jan-95,0,15989135,1669272247,180635035,180635035,98220,2465861,501082,13172022,4492,628,120,748,2.1375,2.1375,0,-22.09,3695401.03,3461596.97,99.94
Feb-95,0,16320050,1744407721,186981702,186981702,84369,2550230,447530,13619552,4475,654,108,762,2.535,2.535,0,-24.49,3623435.57,3449841.46,99.6
Mar-95,0,16666771,1819889916,194128269,194128269,94337,2644567,502811,14122363,4502,608,119,727,4.8125,2.665,-2.1475,-27.06,3701808.97,3461615.55,99.95
Apr-95,0,17025552,1895730892,200902007,200902007,91175,2735742,523581,14645944,4470,615,114,729,5.1625,4.1725,-0.99,-29.6,3796744,3463359.7,99.99
May-95,0,17385676,1971931992,208104643,208104643,87346,2823088,519673,15165617,4485,568,130,698,7.8225,4.12,-3.7025,-31.95,3877089.32,3462560.29,99.97
Jun-95,0,17743663,2048491079,215203082,215203082,83311,2906399,486721,15652338,4496,607,146,753,3.3775,5.79,2.4125,-33.85,3732494.9,3463463.87,100
Jul-95,0,18068434,2125374937,222696127,222696127,83966,2990365,494655,16146993,4483,564,132,696,3.26,7.0025,3.7425,-35.06,3534337.87,3435746.58,99.2
Aug-95,0,18423884,2202614245,230168564,230168564,84555,3074920,516084,16663077,4429,560,127,687,3.235,7.0625,3.8275,-34.52,3425227.94,3351357.81,96.76
Sep-95,0,18765263,2280194932,237496535,237496535,80323,3155243,500254,17163331,4466,585,126,711,3.85,4.9525,1.1025,-28.13,3303543.17,3233367.17,93.36
Oct-95,0,19127285,2358137641,242133903,242133903,71832,3227075,454212,17617543,4429,575,113,688,0.6775,5.79,5.1125,-26.8,3210231.03,3140055.03,90.65
Nov-95,0,19489382,2436442447,249846096,249846096,85092,3312167,514758,18132301,4462,544,115,659,0.92,3.5925,2.6725,-27.53,3120293.1,3050117.1,88.07
Dec-95,0,19849519,2515107390,257726323,257726323,84447,3396614,520482,18652783,4402,588,110,698,2.155,2.365,0.21,-28.83,3065932.52,2995756.52,86.49
Jan-96,0,20214359,2594137173,265603659,265603659,84594,3481208,510876,19163659,4464,577,110,687,1.2425,2.865,1.6225,-30.57,3046361.48,2976185.48,85.92
Feb-96,0,20549206,2673501803,272890695,272890695,79147,3560355,484095,19647754,4473,561,116,677,0.295,4.3575,4.0625,-32.21,3003443.07,2933267.07,84.69
Mar-96,0,20925729,2753242956,280684258,280684258,84191,3644546,497137,20144891,4495,529,129,658,2.1025,4.4125,2.31,-33.86,2952006.55,2881830.55,83.2
Apr-96,0,21307091,2833365471,288181649,288181649,81972,3726518,616167,20761058,4495,576,118,694,2.8,5.81,3.01,-35.53,2942024.6,2871848.6,82.92
May-96,0,21678158,2913859053,295893060,295893060,77351,3803869,621718,21382776,4523,546,137,683,1.1675,6.42,5.2525,-36.92,2904791.71,2834615.71,81.84
Jun-96,0,22053868,2994728345,303321536,303321536,76006,3879875,596033,21978809,4509,596,134,730,2.6125,6.8025,4.19,-36.8,2837558.13,2767382.13,79.9
Jul-96,0,22436200,3075979969,310834462,310834462,72360,3952235,624287,22603096,4496,544,125,669,3.5125,7.7025,4.19,-34.81,2734312.68,2664136.68,76.91
Aug-96,0,22830713,3157626106,318595307,318595307,73694,4025929,624436,23227532,4508,552,116,668,6.065,5.4475,-0.6175,-31.51,2657412.13,2587236.13,74.69
Sep-96,0,23195662,3239637192,326057286,326057286,72167,4098096,596047,23823579,4515,594,110,704,4.08,4.205,0.125,-29.8,2634921.73,2564745.73,74.04
Oct-96,0,23592350,3322044966,333790885,333790885,76622,4174718,638786,24462365,4521,579,92,671,3.52,5.0075,1.4875,-29.41,2945455.84,2875279.84,73.02
Nov-96,0,23977443,3404837833,340938752,340938752,72345,4247063,624855,25087220,4514,531,102,633,8.9425,3.1875,-5.755,-29.88,3362190.17,3277130.27,82.9
Dec-96,0,24362117,3488015374,348470173,348470173,80253,4327316,635522,25722742,4535,590,116,706,3.4575,3.255,-0.2025,-30.87,3909723.84,3803079.45,96.19
Jan-97,0,24711975,3571542773,356077682,356077682,75642,4402958,632998,26355740,4518,592,103,695,0.8525,2.6375,1.785,-32.08,3883782.23,3804770.71,96.24
Feb-97,0,25022152,3655380349,363046859,363046859,68084,4471042,575877,26931617,4489,568,112,680,7.2325,2.2025,-5.03,-33.6,4152631.89,3877908.25,98.08
Mar-97,0,25390860,3739586633,370707223,370707223,74584,4545626,604198,27535815,4513,541,132,673,2.8275,3.6875,0.86,-35.01,4483340.94,3949161.65,99.89
Apr-97,0,25753545,3824155602,378080767,378080767,69774,4615400,557426,28093241,4494,581,129,710,6.2475,4.36,-1.8875,-36.71,4400764.57,3946911.6,99.84
May-97,0,26130397,3909101423,385696901,385696901,68493,4683893,570479,28663720,4475,540,138,678,3.7775,4.62,0.8425,-38.44,4211285.07,3949606.58,99.9
Jun-97,0,26464944,3994381791,392858156,392858156,64631,4748524,519055,29182775,4496,578,154,732,3.94,5.825,1.885,-40.19,4080522.43,3953562.3,100
Jul-97,0,26794274,4079991489,400180285,400180285,63930,4812454,555199,29737974,4474,538,153,691,1.605,7.4775,5.8725,-41.33,4005678.9,3925528.52,99.29
Aug-97,0,27146718,4165953631,408021502,408021502,63348,4875802,552510,30290484,4464,517,145,662,3.35,7.06,3.71,-40.44,3900150.23,3827719.42,96.81
Sep-97,0,27500444,4252269499,415738632,415738632,62001,4937803,598369,30888853,4484,583,116,699,0.8725,6.5025,5.63,-38.59,3756661.9,3686485.9,93.24
Oct-97,0,27862646,4338947569,423585696,423585696,67987,5005790,643408,31532261,4464,551,118,669,5.3575,4.4075,-0.95,-36.47,3584586.29,3514410.29,90.65
Nov-97,0,28206438,4425969431,431193418,431193418,68981,5074771,616084,32148345,4514,524,113,637,1.965,2.8775,0.9125,-35.35,3536878.53,3466702.53,89.41
Dec-97,0,28548206,4513333061,438997960,438997960,71203,5145974,637730,32786075,4498,596,151,747,5.9375,2.5875,-3.35,-35.51,3669697.65,3582843.94,92.41
Jan-98,0,28862743,4601011228,446822459,446822459,72688,5218662,678906,33464981,4488,557,142,699,4.9525,1.7075,-3.245,-36.42,4078569.07,3858411.1,99.52
Feb-98,0,29099821,4688926473,453903764,453903764,65633,5284295,627195,34092176,4493,537,136,673,2.955,2.0325,-0.9225,-37.78,3984056.54,3865725.86,99.71
Mar-98,0,29395682,4777137579,461630841,461630841,72753,5357048,663485,34755661,4515,521,151,672,4.3125,3.8975,-0.415,-39.31,4112404.29,3868737.36,99.79
Apr-98,0,29653123,4865606126,469207926,469207926,67205,5424253,634873,35390534,4515,575,148,723,1.3625,5.355,3.9925,-40.96,3994709.73,3859013,99.53
May-98,0,29936895,4954358445,477171622,477171622,67258,5491511,663578,36054112,4511,544,161,705,1.375,6.005,4.63,-42.56,3893889.1,3814602.52,98.38
Jun-98,0,30236369,5043410238,485065990,485065990,61730,5553241,667541,36721653,4507,562,157,719,1.7325,8.615,6.8825,-34.69,3781966.9,3711790.9,95.73
Jul-98,0,30554941,5132780603,493150893,493150893,61810,5615051,647337,37368990,4518,539,140,679,0.4175,9.815,9.3975,-22.49,3599966.36,3529790.36,91.04
Aug-98,0,30877583,5222473610,501202653,501202653,63207,5678258,622814,37991804,4512,546,142,688,1.5325,7.9,6.3675,-1.04,3399990.9,3329814.9,85.88
Sep-98,0,31175981,5312465015,508963487,508963487,62762,5741020,595098,38586902,4486,577,131,708,2.735,6.1575,3.4225,20.07,3265189,3195013,82.41
Oct-98,0,31488455,5402768894,517105749,517105749,62637,5803657,605116,39192018,4517,587,117,704,5.3575,4.445,-0.9125,16.65,3366319.77,3293401.9,84.94
Nov-98,0,31784674,5493368992,524920315,524920315,61949,5865606,593192,39785210,4520,546,124,670,4.4875,2.625,-1.8625,-2.54,3464557,3385196.47,87.31
Dec-98,0,32071157,5584255573,532317799,532317799,58658,5924264,550924,40336134,4506,615,132,747,4.345,1.6825,-2.6625,-8.47,3667556.03,3540637.52,91.31
Jan-99,0,32293580,5675364577,540130078,540130078,62303,5986567,556710,40892844,4486,657,135,792,2.49,1.99,-0.5,-12.49,3656514.97,3571461.77,92.13
Feb-99,0,32511828,5766691829,547202740,547202740,54561,6041128,506825,41399669,4491,618,125,743,0.32,2.3975,2.0775,-15.82,3687314.43,3586317.07,92.49
Mar-99,0,32738760,5858246013,555041484,555041484,65136,6106264,562783,41962452,4498,601,136,737,3.4225,3.93,0.5075,-19.15,3658482.32,3569544,92.06
Apr-99,0,32956880,5950018317,562532126,562532126,58702,6164966,561775,42524227,4498,600,129,729,2.64,4.6725,2.0325,-12.16,3662503.97,3578939.27,92.31
May-99,0,33213475,6042047216,570411896,570411896,59242,6224208,618875,43143102,4482,618,148,766,5.87,4.85,-1.02,-14.07,3690400.36,3588351.94,92.56
Jun-99,0,33447106,6134309746,578041253,578041253,57967,6282175,594712,43737814,4482,654,159,813,2.5925,6.595,4.0025,-19.98,3722735.37,3625140.67,93.5
Jul-99,0,33698564,6226823734,586079780,586079780,57209,6339384,637949,44375763,4490,603,152,755,0.775,7.915,7.14,-18.66,3614505.39,3543979.42,91.41
Aug-99,0,33940834,6319579992,593263561,593263561,54839,6394223,544277,44920040,4493,556,154,710,0.33,7.4925,7.1625,1.83,3422768.9,3352592.9,86.47
Sep-99,0,34197415,6412592831,601538316,601538316,58467,6452690,587756,45507796,4510,612,144,756,1.8025,5.7375,3.935,7.47,3244408.47,3174232.47,81.87
Oct-99,0,34463075,6505871330,610476999,610476999,62941,6515631,632904,46140700,4530,586,126,712,2.39,4.6275,2.2375,-2.53,3099725.36,3029549.36,78.14
Nov-99,0,34722587,6599409341,619335132,619335132,60925,6576556,621485,46762185,4535,568,120,688,0.55,3.065,2.515,-5.81,3008723.83,2938547.83,75.79
Dec-99,0,35005215,6693229980,628630086,628630086,66612,6643168,649008,47411193,4543,605,146,751,3.04,2.2075,-0.8325,-9.23,2990603.84,2920427.84,75.32
Jan-00,0,35292692,6787338096,638084785,638084785,63636,6706804,671087,48082280,4555,601,135,736,1.7925,3.4875,1.695,-14.21,2969905.16,2899729.16,74.81
Feb-00,0,35578333,6881731853,647256761,647256761,64289,6771093,669706,48751986,4596,589,135,724,1.7675,3.54,1.7725,-16.49,2939424.69,2869248.69,74
Mar-00,0,35843577,6976390854,657388455,657388455,64834,6835927,748195,49500181,4591,582,138,720,3,3.9375,0.9375,-19.09,2999266.58,2929090.58,75.55
Apr-00,0,36086096,7071292374,667373584,667373584,65903,6901830,767359,50267540,4612,606,136,742,3.07,3.7975,0.7275,-20.42,3033613.6,2963437.6,76.43
May-00,0,36341046,7166448844,677766899,677766899,66119,6967949,745794,51013334,4606,609,153,762,3.9225,5.065,1.1425,-11.33,3079791.39,3009615.39,77.62
Jun-00,0,36585918,7261850186,688271814,688271814,59448,7027397,733984,51747318,4620,630,174,804,7.715,5.1125,-2.6025,-13.73,3279239.47,3194392.93,82.39
Jul-00,0,36836800,7357502410,699363762,699363762,61480,7088877,765217,52512535,4639,594,158,752,0.465,7.825,7.36,-1.57,3329559.68,3252408,83.89
Aug-00,0,37094194,7453412028,710826551,710826551,62222,7151099,706796,53219331,4667,595,158,753,0,8.6575,8.6575,21.3,3109172.61,3038996.61,78.38
Sep-00,0,37337515,7549564967,722780206,722780206,57448,7208547,672912,53892243,4691,643,138,781,0.9225,6.6325,5.71,33.37,2905925.37,2835749.37,73.14
Oct-00,0,37620660,7646001051,735762569,735762569,65471,7274018,785901,54678144,4719,628,137,765,4.905,4.9425,0.0375,23.87,2729798.74,2659608.74,69.45
Nov-00,0,37922826,7742739301,747845491,747845491,64008,7338026,745695,55423839,4713,619,145,764,6.86,2.585,-4.275,12.61,2993728.6,2919351.67,76.23
Dec-00,0,38236105,7839790830,760744386,760744386,65989,7404015,825909,56249748,4705,669,147,816,3.785,2.83,-0.955,12.85,3242657.39,3153774.16,82.35
Jan-01,0,38560639,7937166893,773670895,773670895,74736,7478751,807741,57057489,4734,701,141,842,3.0875,2.2325,-0.855,13.12,3519344.58,3399712.55,88.78
Feb-01,0,38864113,8034846430,785767354,785767354,64915,7543666,754140,57811629,4741,686,141,827,6.445,2.12,-4.325,13.45,3857959.54,3618508.64,94.49
Mar-01,0,39221474,8132883328,799068897,799068897,75705,7619371,877745,58689374,4732,637,133,770,4.595,2.795,-1.8,13.76,4350364.48,3827851.32,99.97
Apr-01,0,39571523,8231270275,812886712,812886712,69975,7689346,855005,59544379,4794,611,131,742,1.405,4.23,2.825,13.98,4074243.27,3826577.97,99.94
May-01,0,39931254,8330016953,827655526,827655526,78986,7768332,909660,60454039,4841,627,150,777,3.9025,5.1075,1.205,14.12,3955478.52,3820906.32,99.79
Jun-01,0,40282820,8429115197,842215061,842215061,75009,7843341,854949,61308988,4867,688,159,847,2.0475,6.765,4.7175,14.34,3836281.77,3760310.57,98.2
Jul-01,0,40617708,8528548329,857035395,857035395,74149,7917490,824210,62133198,4915,648,150,798,0.875,8.6925,7.8175,14.49,3732186.58,3659419.32,95.57
Aug-01,0,40962673,8628326426,873237518,873237518,76334,7993824,864026,62997224,4976,637,146,783,3.2975,7.6325,4.335,22.56,3532094,3461904,90.41
Sep-01,0,41302577,8728444427,889479986,889479986,77767,8071591,866886,63864110,5018,681,144,825,3.87,4.73,0.86,12.72,3496176.07,3425986.07,89.48
Oct-01,0,41616110,8828875961,906485707,906485707,91760,8163351,896392,64760502,5068,594,128,722,2.8175,4.625,1.8075,3.42,3491781.84,3420797.65,89.33
Nov-01,0,41978472,8929669857,923458189,923458189,92350,8255701,836696,65597198,5061,606,130,736,2.0175,3.2875,1.27,3.66,3461326.1,3391081.73,88.54
Dec-01,0,42313879,9030799160,942211789,942211789,106680,8362381,920190,66517388,5107,667,126,793,4.09,2.4275,-1.6625,12.95,3553766.23,3441720.23,89.89
Jan-02,0,42703305,9132317889,961687809,961687809,123590,8485971,933655,67451043,5224,632,121,753,2.495,2.4575,-0.0375,4.94,3573832.42,3491698.42,91.19
Feb-02,0,43060874,9234194187,979891067,979891067,115120,8601091,851847,68302890,5251,625,115,740,1.6675,2.8275,1.16,1.09,3728058.25,3627364.46,94.73
Mar-02,0,43465588,9336475199,1000615203,1000615203,122458,8723549,983803,69286693,5321,610,134,744,5.7175,3.61,-2.1075,-0.32,3842499.07,3698601.36,96.58
Apr-02,0,43832832,9439123455,1020839486,1020839486,106839,8830388,1021182,70307875,5399,637,127,764,3.8075,4.3775,0.57,-1.93,4161578.87,3823728.53,99.86
May-02,0,44210516,9542149395,1043098367,1043098367,117477,8947865,1101378,71409253,5476,611,136,747,4.5375,4.7425,0.205,-1.89,3989507.68,3824273.97,99.87
Jun-02,0,44606023,9645570842,1065020668,1065020668,111717,9059582,1095392,72504645,5526,683,157,840,2.685,6.2125,3.5275,-2.8,3897641.03,3798762.43,99.21
Jul-02,0,45081574,9749467840,1087959663,1087959663,112133,9171715,1187951,73692596,5569,666,131,797,3.725,6.275,2.55,-1.35,3830672.71,3753774.42,98.03
Aug-02,0,45631625,9853914889,1111306971,1111306971,111248,9282963,1198653,74891249,5621,649,131,780,1.68,7.2425,5.5625,2.96,3687368.48,3617178.48,94.47
Sep-02,0,46120028,9958850341,1134064174,1134064174,117424,9400387,1240173,76131422,5716,657,121,778,1.8175,5.8725,4.055,5.1,3556825.8,3486635.8,91.02
Oct-02,0,46701909,10064367674,1158620601,1158620601,128328,9528715,1250891,77382313,5741,794,125,919,6.735,3.335,-3.4,7.42,3633923.71,3579697.42,91.79
Nov-02,0,47207872,10170390970,1182573518,1182573518,127612,9656327,1155961,78538274,5790,716,117,833,0.8325,3.16,2.3275,0.45,3763231.77,3718987.87,95.35
Dec-02,0,47807649,10277014043,1207499694,1207499694,139057,9795384,1094681,79632955,5825,847,129,976,4.6075,2.51,-2.0975,-4.35,3770870.9,3728442.97,95.59
Jan-03,0,48413096,10384242563,1233223448,1233223448,147180,9942564,1140287,80773242,5889,781,127,908,0.2775,2.1225,1.845,-7.45,3870930.71,3816565.71,97.85
Feb-03,0,49102348,10492160335,1256918888,1256918888,128925,10071489,1029808,81803050,5910,799,125,924,3.495,1.96,-1.535,-9.52,3875642.96,3824737.93,98.07
Mar-03,0,49940608,10600916367,1284106957,1284106957,146948,10218437,1153198,82956248,6000,754,122,876,1.1725,3.4025,2.23,-12.47,3974607.9,3891881.77,99.79
Apr-03,0,50889434,10710621225,1310719984,1310719984,134780,10353217,1118045,84074293,6065,842,119,961,1.475,5.34,3.865,-12.56,3933139.43,3880627.13,99.5
May-03,0,51918273,10821354922,1338811717,1338811717,134044,10487261,1127551,85201844,6147,772,134,906,3.7175,4.7025,0.985,-12.13,3880965.52,3839658.13,98.46
Jun-03,0,53099767,10933270113,1366898331,1366898331,132436,10619697,1166753,86368597,6223,822,141,963,4.74,5.73,0.99,-9.9,3917097.33,3866855.47,99.15
Jul-03,0,54298434,11046383971,1397094505,1397094505,130449,10750146,1206485,87575082,6296,768,131,899,0.7675,7.685,6.9175,-6.39,3817658.71,3778462.97,96.88
Aug-03,0,55784043,11160983438,1427435547,1427435547,124172,10874318,1391107,88966189,6384,798,127,925,2.4325,7.1275,4.695,10.84,3642030.07,3603046.07,92.38
Sep-03,0,57116886,11276915748,1457868265,1457868265,137866,11012184,1407633,90373822,6483,800,129,929,4.375,4.7625,0.3875,11.64,3567157.73,3528173.73,90.46
Oct-03,0,58250733,11393981905,1489993381,1489993381,134692,11146876,1485850,91859672,6554,797,130,927,1.4725,4.3075,2.835,7.83,3474533.48,3435549.48,88.09
Nov-03,0,59316950,11512114279,1521679739,1521679739,150364,11297240,1468889,93328561,6536,772,124,896,2.525,3.5875,1.0625,4.24,3408524.37,3369540.37,86.39
Dec-03,0,60486319,11631416022,1554948314,1554948314,154354,11451594,1513424,94841985,6677,837,123,960,1.045,3.15,2.105,0.85,3352225.52,3313241.52,84.95
Jan-04,0,61795943,11752027389,1588559305,1588559305,148889,11600483,1542404,96384389,6750,845,124,969,2.5925,2.19,-0.4025,-3.83,3346462.58,3307478.58,84.8
Feb-04,0,62979041,11873821854,1620313650,1620313650,146843,11747326,1445320,97829709,6807,791,125,916,4.31,2.2725,-2.0375,-8.61,3432805.35,3393821.35,87.02
Mar-04,0,64279665,11996916943,1654169389,1654169389,156204,11903530,1687149,99516858,6900,763,127,890,1.9625,3.935,1.9725,-11.72,3597820.07,3558836.07,91.24
Apr-04,0,65539581,12121271948,1688082415,1688082415,149427,12052957,2172131,101688989,6983,807,127,934,4.255,4.13,-0.125,-13.45,3615076.3,3576092.3,91.69
May-04,0,67105767,12247193139,1723389685,1723389685,149340,12202297,2073442,103762431,7040,782,140,922,2.6225,4.87,2.2475,-12.84,3723359.87,3682143.19,94.41
Jun-04,0,68549563,12374558126,1757496138,1757496138,137067,12339364,1966827,105729258,7115,820,155,975,9.9925,5.155,-4.8375,-12.83,3950798.7,3799063.2,97.41
Jul-04,0,69980831,12503354381,1793048063,1793048063,148703,12488067,2315721,108044979,7140,808,158,966,3.965,6.425,2.46,-12.26,3997768.77,3865003.39,99.1
Aug-04,0,71657797,12633827602,1829409554,1829409554,148061,12636128,2260232,110305211,7236,795,160,955,3.0725,6.2,3.1275,-8.13,3900538.58,3831985.29,98.25
Sep-04,0,73257906,12765900932,1865530525,1865530525,143851,12779979,2375344,112680555,7284,861,144,1005,1.04,5.5025,4.4625,-6.64,3794903.87,3753095.9,96.23
Oct-04,0,74980365,12899696721,1903507356,1903507356,149192,12929171,2447547,115128102,7354,810,127,937,5.1225,4.08,-1.0425,-6.72,3756521.19,3709919.55,95.13
Nov-04,0,76987527,13035499672,1941045895,1941045895,143475,13072646,2394992,117523094,7403,787,137,924,7.225,2.5825,-4.6425,-8.19,3883563.8,3759801.43,96.41
Dec-04,0,78747097,13173062193,1979948150,1979948150,149876,13222522,2504122,120027216,7465,802,134,936,0.965,2.54,1.575,-7.69,3959667.71,3864988.13,99.1
Jan-05,0,80601521,13312479138,2019176948,2019176948,155123,13377645,2564534,122591750,7546,755,143,898,3.91,2.1475,-1.7625,-13.62,4010780.16,3888323.07,99.7
Feb-05,0,82274199,13453568761,2056416712,2056416712,145073,13522718,2346740,124938490,7606,645,151,796,2.1125,2.2875,0.175,-19.24,3950693.5,3891823.75,99.78
Mar-05,0,84499012,13596883197,2098778397,2098778397,173653,13696371,3220849,128159339,7684,597,150,747,1.97,3.86,1.89,-18.56,3930214.29,3881832.61,99.54
Apr-05,0,87071942,13742770563,2140359723,2140359723,168100,13864471,3257755,131417094,7739,624,148,772,1.0025,4.925,3.9225,-18.81,3927355.43,3881194.07,99.52
May-05,0,89522549,13891108536,2183794826,2183794826,165117,14029588,3464228,134881322,7821,610,160,770,2.715,4.51,1.795,-17.39,3898840.19,3859780.45,98
Jun-05,0,92062437,14041986397,2227682091,2227682091,155351,14184939,3475369,138356691,7837,645,171,816,1.4625,6.81,5.3475,-13.33,3828455.6,3789125.93,96.21
Jul-05,0,94751607,14195553428,2274530302,2274530302,160079,14345018,3900711,142257402,7968,640,165,805,2.79,6.74,3.95,-4.55,3678309.58,3639325.58,92.39
Aug-05,0,97501982,14351870834,2323616500,2323616500,156999,14502017,4710895,146968297,8050,654,163,817,2.7225,6.67,3.9475,0.95,3545659.19,3506675.19,89.04
Sep-05,0,99919972,14510606230,2371031909,2371031909,143725,14645742,4899910,151868207,8132,669,143,812,1.0725,6.7975,5.725,-15.65,3394350.53,3355366.53,85.19
Oct-05,0,102801453,14672223107,2421639859,2421639859,167623,14813365,5074895,156943102,8192,659,161,820,0.77,5.14,4.37,-12.96,3248830.13,3209846.13,81.49
Nov-05,0,105649677,14836688208,2473616585,2473616585,170772,14984137,5601337,162544439,8266,605,142,747,0.7925,4.3675,3.575,-11.34,3145730.63,3106746.63,78.88
Dec-05,0,108939678,15004443310,2528113048,2528113048,184483,15168620,7115410,169659849,8320,689,155,844,0.32,3.0625,2.7425,-10.32,3061124,3022140,76.74
Jan-06,0,112321258,15175579992,2583592890,2583592890,201693,15370313,6705941,176365790,8417,650,153,803,2.4175,4.175,1.7575,-9.93,3004247.19,2965263.19,75.28
Feb-06,0,115490494,15349885910,2634348848,2634348848,172395,15542708,5610917,181976707,8542,613,164,777,2.6225,2.8875,0.265,-9.77,3001200.54,2962216.54,75.21
Mar-06,0,119586328,15528287662,2692272993,2692272993,173853,15716561,6845298,188822005,8634,637,173,810,4.925,4.9225,-0.0025,-10.19,3144233.19,3104560.13,78.82
Apr-06,0,123810970,15710914056,2750643743,2750643743,175605,15892166,7540903,196362908,8732,632,170,802,2.9975,5.495,2.4975,-10.65,3301563.43,3261832.97,82.82
May-06,0,128573670,15898303150,2813315060,2813315060,179125,16071291,7671075,204033983,8737,635,177,812,2.1125,5.83,3.7175,-11.08,3294273,3255014.77,82.65
Jun-06,0,133394090,16090512664,2874960823,2874960823,146413,16217704,7031262,211065245,8956,661,170,831,1.5325,7.45,5.9175,-11.33,3159547.27,3120563.27,79.23
Jul-06,0,138584877,16287912965,2939625829,2939625829,168225,16385929,8401320,219466565,9029,638,185,823,0.8,8.58,7.78,-10.45,3002470.61,2963486.61,75.24
Aug-06,0,144534996,16491263385,3005606305,3005606305,164188,16550117,8069970,227536535,9140,637,178,815,2.04,8.9775,6.9375,-7.94,2828563.9,2789579.9,70.82
Sep-06,0,150584155,16700662964,3072551191,3072551191,169292,16719409,8510849,236047384,9228,650,158,808,2.6425,5.9875,3.345,-3.61,2705237.13,2666253.13,67.69
Oct-06,0,157054946,16916533334,3142913464,3142913464,199977,16919386,8413314,244460698,9377,640,137,777,3.8425,4.97,1.1275,-0.02,2620773.71,2581789.71,65.55
Nov-06,0,163737047,17139085805,3211837753,3211837753,180453,17099839,7314293,251774991,9458,603,142,745,2.7125,3.2375,0.525,1.94,2605249.93,2566265.93,65.15
Dec-06,0,171521112,17369422341,3285994394,3285994394,217109,17316948,7679469,259454460,9608,708,154,862,3.46,2.51,-0.95,2.72,2593026.42,2554042.42,64.84
Jan-07,0,179042164,17607279929,3361299764,3361299764,200034,17516982,7961465,267415925,9674,615,148,763,4.2025,2.2075,-1.995,2.94,2903919.42,2864935.42,72.74
Feb-07,0,186354515,17852449868,3431627342,3431627342,204552,17721534,7363908,274779833,9834,617,162,779,0.7175,2.98,2.2625,2.21,3083404,3044420,77.29
Mar-07,0,195074623,18106339915,3513871743,3513871743,202893,17924427,9471116,284250949,10052,627,162,789,6.445,3.9675,-2.4775,1.64,3066861.65,3027877.65,76.87
Apr-07,0,204024146,18369179485,3596595557,3596595557,209751,18134178,12678118,296929067,10144,628,169,797,2.7125,4.1,1.3875,1.23,3322338.5,3281813.33,83.33
May-07,0,214064138,18642059047,3686275336,3686275336,208858,18343036,13885623,310814690,10389,612,175,787,8.58,3.9725,-4.6075,0.69,3624907.03,3558516,90.35
Jun-07,0,224227824,18925102295,3776449492,3776449492,201599,18544635,12610359,323425049,10548,660,184,844,10.8775,5.375,-5.5025,-0.18,4114733.47,3823991.03,97.09
Jul-07,0,235482738,19219400457,3873672846,3873672846,194596,18739231,12708560,336133609,10695,617,170,787,4.6875,5.22,0.5325,-0.89,4919172.87,3938339.74,100
Aug-07,0,247129577,1.95E+10,3.98E+09,3977672846,197659,18936890,11365594,347499203,10912,665,176,841,1.9175,6.5325,4.615,-1.74,4416974.61,3927467.07,99.72
Sep-07,0,258553525,1.98E+10,4.08E+09,4080672846,197758,19134648,12171152,359670355,11088,648,147,795,3.56,4.7175,1.1575,-1.93,4136973.97,3891497.37,98.8
Oct-07,0,270892443,2.02E+10,4.19E+09,4190672846,205795,19340443,16080622,375750977,11304,584,135,719,2.6125,4.66,2.0475,-2.12,3920962.77,3850783.71,97.76
Nov-07,0,283914768,2.05E+10,4.30E+09,4301672846,231590,19572033,15250493,391001470,11411,594,136,730,1.4525,3.65,2.1975,-4.29,3824198.6,3784930.8,96.09
Dec-07,0,296726938,2.09E+10,4.42E+09,4419672846,232967,19805000,15082811,406084281,11668,640,144,784,2.255,2.34,0.085,-7.06,3798864.9,3758951.13,95.43
Jan-08,0,309680355,2.12E+10,4.54E+09,4540672846,257794,20062794,16057366,422141647,11838,566,147,713,0.58,2.5875,2.0075,-7.14,3792256.77,3752684.23,95.27
Feb-08,0,323974332,2.16E+10,4.66E+09,4656672846,233387,20296181,18653056,440794703,12065,570,155,725,2.165,2.985,0.82,-7.23,3831440.31,3789648.03,96.22
Mar-08,0,340593299,2.20E+10,4.78E+09,4782672846,264086,20560267,17527121,458321824,12200,563,151,714,7.05,4.4225,-2.6275,-7.42,4168792.1,3927299.87,99.71
Apr-08,0,356146338,2.24E+10,4.91E+09,4906672846,251200,20811467,15657553,473979377,12323,579,158,737,4.5625,4.935,0.3725,-7.75,4152301.43,3935292.33,99.91
May-08,0,373601902,2.29E+10,5.04E+09,5040672846,260077,21071544,17246565,491225942,12669,531,161,692,3.29,5.1925,1.9025,-6.53,4021868.03,3934751.65,99.91
Jun-08,0,390141590,2.33E+10,5.17E+09,5171672846,239858,21311402,26307646,517533588,12790,549,152,701,2.2675,7.5625,5.295,-6.8,3988094.13,3921738.13,99.57
Jul-08,0,407627641,2.38E+10,5.31E+09,5309672846,231552,21542954,42688158,560221746,13022,515,159,674,1.015,8.3525,7.3375,-6.68,3856066.74,3808122.32,96.69
Aug-08,0,425516985,2.43E+10,5.45E+09,5452672846,239890,21782844,36569975,596791721,13238,529,147,676,4.3,6.6325,2.3325,29.5,3725653.71,3686669.71,93.6
Sep-08,0,442990369,2.48E+10,5.59E+09,5592672846,222056,22004900,34063161,630854882,13481,523,131,654,2.05,5.095,3.045,30.93,3675638.13,3636654.13,92.32
Oct-08,8,461503734,2.53E+10,5.74E+09,5741672846,257775,22262675,28967355,659822237,13686,509,122,631,1.4675,4.9525,3.485,32.51,3580161.74,3541177.74,89.91
Nov-08,10,480194512,2.58E+10,5.89E+09,5887672846,255093,22517768,24798340,684620577,13790,554,128,682,2.16,4.0675,1.9075,33.76,3515580.33,3476596.33,88.28
Dec-08,10,498270524,2.64E+10,6.04E+09,6040672846,268990,22786758,23654510,708275087,13919,588,132,720,0.675,3.0325,2.3575,34.47,3470617.77,3431633.77,87.13
Jan-09,10,516583693,2.70E+10,6.20E+09,6195672846,292327,23079085,33626835,741901922,14077,536,139,675,1.0625,2.61,1.5475,34.58,3445031.07,3406047.07,86.48
Feb-09,10,533583317,2.76E+10,6.34E+09,6338672846,259707,23338792,31219939,773121861,14291,528,129,657,1.12,3.59,2.47,34.48,3418085.46,3379101.46,85.8
Mar-09,10,551627229,2.82E+10,6.50E+09,6497672846,276404,23615196,32788001,805909862,14458,514,130,644,4.24,4.535,0.295,34.05,3443402.84,3404418.84,86.44
Apr-09,10,568407282,2.88E+10,6.65E+09,6649672846,261764,23876960,32575248,838485110,14505,519,127,646,6.06,5.14,-0.92,33.32,3491069.5,3450597.5,87.6
May-09,14,584973482,2.94E+10,6.80E+09,6803672846,246847,24123807,32742768,871227878,14559,516,124,640,5.0675,4.2125,-0.855,1.74,4016234.48,3890624.13,98.78
Jun-09,20,600585522,3.01E+10,6.95E+09,6950672846,231208,24355015,32837048,904064926,14631,576,133,709,2.7375,6.9025,4.165,1.29,3963638.87,3899416.8,99
Jul-09,21,617574115,3.08E+10,7.10E+09,7100672846,220824,24575839,33742751,937807677,14618,537,130,667,3.5925,7.44,3.8475,31.67,3834570.65,3793965.26,96.33
Aug-09,21,633182209,3.15E+10,7.25E+09,7248672846,214491,24790330,36033135,973840812,14681,559,124,683,2.0675,7.64,5.5725,35.14,3745381.29,3702914.45,94.42
Sep-09,22,648413928,3.22E+10,7.39E+09,7389672846,200271,24990601,37981586,1011822398,14627,543,114,657,7.685,4.8275,-2.8575,65.78,3719338.57,3672221.13,93.64
Oct-09,23,664364872,3.29E+10,7.54E+09,7535672846,199931,25190532,59426419,1071248817,14641,545,128,673,11.0125,3.68,-7.3325,50.77,4051348.23,3799784,98.66
Nov-09,23,679974688,3.36E+10,7.68E+09,7676672846,216032,25406564,43611138,1114859955,14699,529,120,649,1.48,3.1825,1.7025,41.17,4106290.37,3851058.1,100
Dec-09,24,695611121,3.44E+10,7.82E+09,7821672846,205586,25612150,40261446,1155121401,14837,606,126,732,2.3425,2.215,-0.1275,33.54,3964757.65,3850512.23,99.99
Jan-10,24,712229886,3.52E+10,7.97E+09,7969672846,215853,25828003,30695325,1185816726,14824,553,130,683,3.185,2.055,-1.13,28.77,3967303.55,3850766.07,99.99
Feb-10,24,727436240,3.59E+10,8.10E+09,8104672846,192974,26020977,27328537,1213145263,14985,548,136,684,3.4125,2.4425,-0.97,25.7,4206136.07,3851262.54,100
Mar-10,24,745141539,3.67E+10,8.26E+09,8255672846,214014,26234991,29825636,1242970899,15110,519,137,656,3.7325,4.0225,0.29,21.99,4036906.58,3851243.39,100
Apr-10,24,762609694,3.76E+10,8.40E+09,8396672846,202340,26437331,27328507,1270299406,14854,549,137,686,2.7825,4.8,2.0175,18.48,3956487.83,3849251.77,99.95
May-10,24,780494553,3.84E+10,8.55E+09,8550672846,196903,26634234,22858726,1293158132,15293,534,134,668,2.45,5.1775,2.7275,20.18,3915028.32,3832424.13,99.51
Jun-10,24,797937663,3.93E+10,8.70E+09,8699672846,172830,26807064,20470743,1313628875,15400,574,139,713,2.5475,6.725,4.1775,22.74,3815722.77,3745006.13,97.23
Jul-10,24,816868508,4.01E+10,8.86E+09,8857672846,191109,26998173,21977628,1335606503,15533,564,144,708,3.6825,6.67,2.9875,25.12,3742675.65,3672029.52,95.35
Aug-10,24,835661257,4.10E+10,9.02E+09,9016672846,196453,27194626,21146247,1356752750,15626,570,139,709,1.11,7.78,6.67,28.91,3576272.13,3505851.13,91.02
Sep-10,24,854249294,4.19E+10,9.18E+09,9175672846,184626,27379252,20654733,1377407483,15772,585,128,713,8.15,5.3575,-2.7925,31.32,3629756.8,3523203.17,91.49
Oct-10,24,870871933,4.29E+10,9.34E+09,9339672846,208569,27587821,24811940,1402219423,15868,556,128,684,1.665,5.0625,3.3975,32.15,3577048.1,3505847.58,91.04
Nov-10,26,888892203,4.38E+10,9.50E+09,9499672846,202905,27790726,28743526,1430962949,15898,581,135,716,1.97,3.385,1.415,32.71,3549060.5,3478639.5,90.33
Dec-10,26,907049264,4.48E+10,9.67E+09,9665672846,210972,28001698,35065477,1466028426,16057,622,141,763,1.9225,3.225,1.3025,31.88,3489733.52,3419312.52,88.78
Jan-11,26,924945011,4.58E+10,9.83E+09,9829672846,199987,28201685,33880224,1499908650,16074,575,136,711,1.3625,1.9925,0.63,29.23,3511952.71,3441531.71,89.36
Feb-11,26,940493885,4.68E+10,9.97E+09,9969672846,176065,28377750,23877440,1523786090,16028,617,149,766,1.2975,2.365,1.0675,27.05,3527027.57,3456606.57,89.75
Mar-11,26,960259680,4.78E+10,1.01E+10,10138672846,246378,28624128,32153730,1555939820,16219,566,134,700,0.2025,4.5925,4.39,25.57,3511798.13,3441377.13,89.36
Apr-11,26,980651537,4.88E+10,1.03E+10,10303672846,197649,28821777,31105153,1587044973,16345,569,147,716,2.7775,6.2875,3.51,28.77,3472171.4,3401750.4,88.32
May-11,26,1001480178,4.99E+10,1.05E+10,10475672846,203464,29025241,31193591,1618238564,16452,607,142,749,4.8125,5.5875,0.775,26.58,3595675.19,3523141.42,91.48
Jun-11,28,1020820259,5.10E+10,1.06E+10,10639672846,185698,29210939,28513757,1646752321,16554,590,154,744,1.48,8.2075,6.7275,32.64,3580322.8,3509777.67,91.13
Jul-11,29,1040555852,5.21E+10,1.08E+10,10807672846,192335,29403274,27375351,1674127672,16594,575,153,728,0.0525,9.1725,9.12,54.27,3407504.9,3337083.9,86.65
Aug-11,31,1060317099,5.32E+10,1.10E+10,10976672846,195742,29599016,25197506,1699325178,16715,603,155,758,0.665,9.995,9.33,38.02,3188976.68,3118555.68,80.96
Sep-11,32,1079519274,5.43E+10,1.11E+10,11144672846,178039,29777055,25547878,1724873056,16805,605,147,752,1.09,7.5525,6.4625,44.77,2989250.23,2918829.23,75.79
Oct-11,32,1101738114,5.55E+10,1.13E+10,11318672846,196427,29973482,28217233,1753090289,16927,576,148,724,3.975,5.4775,1.5025,43.27,2875656.9,2805235.9,72.83
Nov-11,32,1121510523,5.67E+10,1.15E+10,11490672846,204749,30178231,29239970,1782330259,16962,626,148,774,2.27,3.7975,1.5275,41.57,2813074.23,2742653.23,71.21
Dec-11,33,1141417467,5.79E+10,1.17E+10,11664672846,221745,30399976,28511487,1810841746,16951,669,146,815,4.05,2.4875,-1.5625,40.65,2875342.13,2804921.13,72.84
Jan-12,34,1161692876,5.91E+10,1.18E+10,11835672846,214359,30614335,27390925,1838232671,17050,596,142,738,5.6,2.6325,-2.9675,57.22,3030593.26,2955852.87,76.75
Feb-12,34,1180649907,6.03E+10,1.20E+10,11993672846,205558,30819893,25904514,1864137185,17024,566,150,716,2.25,2.6375,0.3875,32.17,3436507.79,3357249.17,87.18
Mar-12,34,1201173699,6.16E+10,1.22E+10,12167672846,216863,31036756,28006027,1892143212,17092,552,142,694,5.6825,3.6425,-2.04,29.44,3670169.13,3544140.97,92.03
Apr-12,34,1220046498,6.29E+10,1.23E+10,12333672846,194713,31231469,28799545,1920942757,17160,548,150,698,1.825,4.3475,2.5225,27.84,3902804.97,3783099.4,98.23
May-12,34,1239323928,6.42E+10,1.25E+10,12505672846,223935,31455404,29361990,1950304747,17134,562,151,713,2.8225,5.8975,3.075,27.17,3816987.77,3744614.1,97.24
Jun-12,41,1257177132,6.55E+10,1.27E+10,12670672846,184409,31639813,27810021,1978114768,17197,574,168,742,3.0975,6.57,3.4725,28.89,3784393.87,3713613.43,96.42
Jul-12,47,1275888814,6.68E+10,1.28E+10,12844672846,194899,31834712,26345755,2004460523,17277,579,158,737,1.415,7.955,6.54,34.45,3639869.39,3569448.39,92.68
Aug-12,47,1294369449,6.82E+10,1.30E+10,13016672846,175000,32009712,23584310,2028044833,17273,579,161,740,3.265,8.075,4.81,37.25,3474879.9,3404458.9,88.4
Sep-12,49,1311608510,6.95E+10,1.32E+10,13182672846,187087,32196799,22528818,2050573651,17250,608,139,747,2.7125,6.35,3.6375,42.37,3344875.9,3274454.9,85.02
Oct-12,51,1329395984,7.09E+10,1.34E+10,13351672846,189495,32386294,22820501,2073394152,17300,587,132,719,1.275,4.35,3.075,41.1,3252606.81,3182185.81,82.63
Nov-12,52,1345538883,7.23E+10,1.35E+10,13503672846,193477,32579771,22389782,2095783934,17207,590,148,738,0.16,4.075,3.915,39.34,3158724.5,3088303.5,80.19
Dec-12,53,1361802650,7.38E+10,1.37E+10,13662672846,192586,32772357,22885441,2118669375,17311,633,140,773,1.7925,2.755,0.9625,37.15,3086690.23,3016269.23,78.31
Jan-13,54,1379158208,7.52E+10,1.38E+10,13824672846,200005,32972362,22272924,2140942299,17342,605,155,760,3.4425,2.7175,-0.725,36.03,3138654.19,3068233.19,79.67
Feb-13,57,1394804209,7.66E+10,1.40E+10,13970672846,199110,33171472,21463121,2162405420,17318,608,140,748,1.83,3.1,1.27,33.81,3156038,3085617,80.13
Mar-13,60,1412240379,7.81E+10,1.41E+10,14131672846,213385,33384857,24321065,2186726485,17383,607,150,757,2.3025,4.6625,2.36,30.52,3136186.23,3065765.23,79.6
Apr-13,61,1429024090,7.96E+10,1.43E+10,14285672846,206644,33591501,22064761,2208791246,17422,639,159,798,2.91,4.9375,2.0275,27.83,3160557.53,3090136.53,80.24
May-13,61,1446097118,8.11E+10,1.44E+10,14444672846,216886,33808387,20560746,2229351992,17390,648,164,812,4.22,4.9375,0.7175,26.39,3133173.16,3062752.16,79.53
Jun-13,61,1462332768,8.26E+10,1.46E+10,14597672846,189773,33998160,20198437,2249550429,17467,657,181,838,2.7825,7.21,4.4275,26.22,3154526.4,3084105.4,80.08
Jul-13,61,1479652533,8.42E+10,1.48E+10,14755672846,200164,34198324,21710697,2271261126,17446,639,171,810,3.1,7.395,4.295,25.76,3039669.68,2969248.68,77.09
Aug-13,61,1496097663,8.57E+10,1.49E+10,14913672846,190223,34388547,20305898,2291567024,17455,687,180,867,0.735,8.375,7.64,27.39,2901360.16,2830939.16,73.51
Sep-13,61,1511962276,8.73E+10,1.51E+10,15065672846,208157,34596704,19478878,2311045902,17467,649,150,799,3.2,6.5175,3.3175,31.82,2760723.67,2690302.67,69.86
Oct-13,62,1528183820,8.89E+10,1.52E+10,15222672846,211709,34808413,20677641,2331723543,17523,624,155,779,4.335,3.7675,-0.5675,33.38,2698797.03,2628376.03,68.25
Nov-13,83,1543519682,9.05E+10,1.54E+10,15372672846,202280,35010693,20624085,2352347628,17468,658,167,825,2.615,3.065,0.45,31.56,2689938.27,2619517.27,68.01
Dec-13,91,1557772360,9.21E+10,1.55E+10,15516672846,210135,35220828,19190718,2371538346,17359,696,169,865,2.7825,1.8725,-0.91,29.9,2709561.36,2639140.36,68.52
Jan-14,94,1572687044,9.37E+10,1.57E+10,15663672846,239506,35460334,20970103,2392508449,17395,649,166,815,0.4225,2.1875,1.765,28.32,2744336.07,2673915.07,69.43
Feb-14,95,1585828256,9.54E+10,1.58E+10,15794672846,191944,35652278,17602129,2410110578,17288,623,161,784,0.69,2.54,1.85,26.81,2717033.43,2646612.43,68.72
Mar-14,95,1601361124,9.70E+10,1.59E+10,15941672846,219550,35871828,19692659,2429803237,17392,621,166,787,1.435,3.3225,1.8875,23.91,2691668.94,2621247.94,68.07
Apr-14,96,1616497347,9.87E+10,1.61E+10,16084672846,202628,36074456,21177215,2450980452,17414,607,169,776,2.44,5.975,3.535,21.14,2705300.5,2634879.5,68.42
May-14,96,1632093348,1.00E+11,1.62E+10,16230672846,222059,36296515,23572748,2474553200,17445,670,194,864,3.97,5.8275,1.8575,20.52,2750687.65,2680266.65,69.59
Jun-14,96,1647124520,1.02E+11,1.64E+10,16370672846,202268,36498783,23152583,2497705783,17432,652,210,862,4.785,6.4475,1.6625,19.05,2732900.3,2662479.3,69.12
Jul-14,97,1661999373,1.04E+11,1.65E+10,16512672846,196795,36695578,23303518,2521009301,17377,643,199,842,3.9925,6.955,2.9625,19.61,2706845.48,2636424.48,68.45
Aug-14,97,1676680283,1.06E+11,1.67E+10,16653672846,185323,36880901,19485692,2540494993,17405,669,193,862,1.6575,7.5725,5.915,21.19,2782334.26,2711913.26,70.42
Sep-14,100,1690661334,1.07E+11,1.68E+10,16788672846,197284,37078185,18837801,2559332794,17457,672,171,843,1.2775,5.845,4.5675,25.58,2666120.8,2595699.8,67.4
Oct-14,102,1704831623,1.09E+11,1.69E+10,16927672846,184891,37263076,20073102,2579405896,17454,651,164,815,3.1825,5.3175,2.135,27.79,2593433.19,2523012.19,65.52
Nov-14,110,1718818142,1.11E+11,1.71E+10,17060672846,189515,37452591,22054491,2601460387,17415,691,181,872,2.4275,3.5875,1.16,27.77,2529147.13,2458726.13,63.85
Dec-14,118,1736224956,1.13E+11,1.72E+10,17198672846,200176,37652767,23976360,2625436747,17420,760,181,941,1.465,2.1075,0.6425,25.97,2492674.07,2422253.07,62.9
Jan-15,144,1749694694,1.14E+11,1.73E+10,17333672846,195104,37847871,20910258,2646347005,17364,726,186,912,3.3,2.47,-0.83,21.52,2534349.26,2463928.26,63.97
Feb-15,145,1761570538,1.16E+11,1.75E+10,17453672846,157073,38004944,20961413,2667308418,17290,681,182,863,2.8775,2.745,-0.1325,18.39,2585087.43,2514666.43,65.29
Mar-15,150,1775202194,1.18E+11,1.76E+10,17584672846,184432,38189376,24003133,2691311551,17242,717,197,914,3.7675,3.1175,-0.65,16.32,2950826.1,2880405.1,74.79
Apr-15,155,1787952948,1.20E+11,1.77E+10,17711672846,166557,38355933,22833083,2714144634,17144,695,198,893,7.0775,5.16,-1.9175,14.33,3318191.07,3233938.23,83.97
May-15,163,1801427610,1.22E+11,1.78E+10,17840672846,155305,38511238,23392837,2737537471,17010,718,205,923,15.7825,5.17,-10.6125,12.52,4464314.16,3745525.45,97.25
Jun-15,167,1813936792,1.24E+11,1.80E+10,17962672846,139957,38651195,23028671,2760566142,16994,725,204,929,5.6125,7.1975,1.585,11.59,5157297.53,3851272,100
Jul-15,170,1825921212,1.26E+11,1.81E+10,18087672846,139092,38790287,23636124,2784202266,16860,714,215,929,1.33,7.9675,6.6375,12.86,4722500.52,3848595.48,99.94
Aug-15,174,1837203334,1.27E+11,1.82E+10,18211672846,134790,38925077,22888506,2807090772,16852,699,216,915,0.85,8.015,7.165,22.36,4135039.87,3766407.87,98.13
Sep-15,180,1847541909,1.29E+11,1.83E+10,18330672846,122029,39047106,20900256,2827991028,16823,695,185,880,1.1075,6.5975,5.49,34.29,3777091.6,3669287.9,95.59
Oct-15,190,1858560798,1.31E+11,1.85E+10,18451672846,123987,39171093,19889406,2847880434,16834,693,172,865,9.9475,5.87,-4.0775,34.33,3686358.23,3607842,93.98
Nov-15,193,1869508822,1.33E+11,1.86E+10,18568672846,126028,39297121,18658705,2866539139,16731,682,176,858,9.5475,3.6375,-5.91,33.43,4041039.33,3802115.6,99.05
Dec-15,200,1880575016,1.35E+11,1.87E+10,18687672846,134159,39431280,18697919,2885237058,16611,768,190,958,5.1375,3.1225,-2.015,31.46,4706770.39,3834510.23,99.89
Jan-16,201,1891598599,1.37E+11,1.88E+10,18804672846,137128,39568408,19117649,2904354707,16624,689,187,876,0.855,2.21,1.355,28.46,4596524.84,3828012.58,99.72
Feb-16,202,1901950508,1.39E+11,1.89E+10,18914672846,131525,39699933,16814984,2921169691,16469,617,187,804,1.9325,3.4025,1.47,26.32,4147190.07,3824907.17,99.63
Mar-16,202,1912440172,1.41E+11,1.90E+10,19030672846,132033,39831966,18282564,2939452255,16428,650,186,836,4.445,4.1,-0.345,25.47,4186039.52,3835403.65,99.92
Apr-16,202,1922525675,1.43E+11,1.91E+10,19141672846,107094,39939060,17103613,2956555868,16452,675,195,870,6.6075,4.425,-2.1825,21.99,4121342.37,3834033.57,99.88
May-16,202,1933541508,1.45E+11,1.93E+10,19256672846,117030,40056090,16217358,2972773226,16408,678,193,871,5.335,4.2575,-1.0775,19.08,4127242.26,3835506.71,99.92
Jun-16,202,1944336081,1.47E+11,1.94E+10,19364672846,104648,40160738,15572866,2988346092,16447,713,198,911,4.6525,6.3275,1.675,17.72,4412655.17,3837096.13,99.96
Jul-16,202,1955208403,1.49E+11,1.95E+10,19475672846,93910,40254648,16056017,3004402109,16400,683,197,880,2.095,8.405,6.31,19.76,4006041.9,3805996.9,99.14
Aug-16,202,1966064036,1.51E+11,1.96E+10,19584672846,94415,40349063,16119077,3020521186,16381,730,197,927,4.1525,4.7275,0.575,22.86,3792153.42,3713079.1,96.72
Sep-16,204,1976233136,1.53E+11,1.97E+10,19688672846,86624,40435687,17543832,3038065018,16378,700,176,876,2.475,5.03,2.555,23.43,3732224.9,3659237.87,95.33
Oct-16,204,1986465534,1.55E+11,1.98E+10,19795672846,94480,40530167,19626300,3057691318,16348,698,178,876,1.8125,4.78,2.9675,23.2,3667534.32,3593539.39,93.61
Nov-16,204,1996516350,1.57E+11,1.99E+10,19897672846,99028,40629195,18087862,3075779180,16330,743,188,931,3.27,3.4775,0.2075,22.82,3673933.33,3593625.13,93.61
Dec-16,204,2006512977,1.59E+11,2.00E+10,20000672846,101517,40730712,18425145,3094204325,16281,785,184,969,0.8025,2.48,1.6775,21.16,3656802.45,3580222.16,93.27
Jan-17,204,2016692342,1.61E+11,2.01E+10,20103672846,98677,40829389,19501997,3113706322,16268,709,182,891,3.0575,2.81,-0.2475,19.83,3678955.87,3588269.84,93.47
Feb-17,204,2025909296,1.63E+11,20197313108,20197313108,94926,40924315,18009449,3131715771,16220,644,179,823,2.2325,3.5975,1.365,18.04,3695004.54,3614584.04,94.16
Mar-17,204,2035748354,1.66E+11,2.03E+10,20299313108,101292,41025607,20240610,3151956381,16266,647,184,831,1.5525,4.17,2.6175,14.06,3700849.29,3626595.65,94.47
Apr-17,204,2045413867,1.68E+11,20397869023,20397869023,89717,41115324,20556051,3172512432,16268,705,186,891,4.365,4.4075,0.0425,12.87,3793581.97,3699060.3,96.36
May-17,205,2055453544,1.70E+11,2.05E+10,20498869023,87315,41202639,21128600,3193641032,16264,669,193,862,1.985,4.8425,2.8575,12.99,3805615.9,3729548.77,97.15
Jun-17,206,2065096151,1.72E+11,20595671745,20595671745,78270,41280909,20685419,3214326451,16291,712,200,912,5.935,5.815,-0.12,12.33,3855823.37,3763742.07,98.04
Jul-17,206,2074993278,1.74E+11,20694485459,20694485459,73118,41354027,21174435,3235500886,16316,682,204,886,3.8725,8.035,4.1625,11.83,3847443.68,3768309.71,98.16
Aug-17,207,2085103598,1.76E+11,20791712222,20791712222,70999,41425026,22898536,3258399422,16258,704,200,904,6.2725,5.8375,-0.435,13.14,3887585.07,3776452.97,98.38
Sep-17,209,2094744716,1.78E+11,20885157710,20885157710,77236,41502262,20681233,3279080655,16276,680,181,861,1.215,5.575,4.36,16,3880640.3,3799914,98.98
Oct-17,209,2104734385,1.80E+11,20981563591,20981563591,72122,41574384,23057210,3302137865,16256,667,181,848,2.025,4.9175,2.8925,18.55,3767160.07,3696739.07,96.3
Nov-17,209,2114622764,1.83E+11,21074332291,21074332291,88311,41662695,20809609,3322947474,16177,686,175,861,1.0775,2.785,1.7075,19.19,3681313.07,3610892.07,94.07
Dec-17,209,2124449221,1.85E+11,21171075142,21171075142,85223,41747918,21454629,3344402103,16241,793,186,979,3.0875,2.6875,-0.4,17.65,3658121.81,3587700.81,93.46
Jan-18,210,2133945392,1.87E+11,21264145640,21264145640,93198,41841116,20154157,3364556260,16170,682,181,863,0.5925,1.74,1.1475,15.84,3694867.03,3624446.03,94.41
Feb-18,210,2142870506,1.89E+11,21349428847,21349428847,86373,41927489,20162015,3384718275,16107,646,180,826,6.9125,1.905,-5.0075,14.13,3828812.07,3678376.43,95.82
Mar-18,210,2152677960,1.91E+11,21443299822,21443299822,99406,42026895,21496725,3406215000,16105,637,181,818,3.2925,3.765,0.4725,10.93,4123874.68,3835247.81,99.92
Apr-18,210,2161476766,1.94E+11,21533475865,21533475865,89716,42116611,20685295,3426900295,16126,695,177,872,1.425,3.835,2.41,9.35,3920908.53,3821605.7,99.56
May-18,211,2170125395,1.96E+11,21627578125,21627578125,95350,42211961,21619127,3448519422,16080,662,192,854,3.0475,5.495,2.4475,8.81,3881619.48,3803149.77,99.07
Jun-18,211,2178414150,1.98E+11,21718385552,21718385552,69578,42281539,21265718,3469785140,16019,723,208,931,1.135,6.865,5.73,11.03,3781238.77,3710817.77,96.67
Jul-18,212,2187006070,2.00E+11,21809565077,21809565077,77387,42358926,20631208,3490416348,15926,682,189,871,1.46,7.3525,5.8925,19.12,3627859.71,3557438.71,92.67
Aug-18,213,2195748619,2.03E+11,21900515084,21900515084,79687,42438613,19876432,3510292780,15916,716,189,905,4.085,7.1125,3.0275,22.98,3505897.07,3435476.07,89.5
Sep-18,213,2204327760,2.05E+11,21988199210,21988199210,76076,42514689,19915848,3530208628,15884,663,165,828,9.8625,3.245,-6.6175,24.5,3637249.17,3513732.8,91.53
Oct-18,213,2204819589,2.07E+11,22078473450,22078473450,79202,42593891,19386237,3549594865,15794,855,300,1155,10.8525,2.9825,-7.87,25.67,4307081.74,3807478.74,99.18
Nov-18,213,2213398730,2.09E+11,22164247631,22164247631,82269,42676160,17368351,3566963216,15334,756,232,988,2.3925,2.36,-0.0325,13.79,4462296.7,3833020.4,99.85
Dec-18,213,2221977871,2.12E+11,22251883308,22251883308,78270,42754430,17381382,3584344598,14860,541,289,830,4.9175,2.0875,-2.83,11.19,4100366.84,3832047.9,99.82